# chateau avec des pieges !
# Rappel : team 0 is top, team 1 bottom
# team 0 hamsters is H, team 1 is h
20 20
HHH...X.............
......X.............
......X.............
....................
OXOXOXOOOOOOOOO.....
OXXXXXXXXXXXXXOO....
OX.OO........XOOO...
OXXPP........XOOOO..
OXXPP..OXOXOXXOOOO..
OXOPP...............
OXOPP...............
OXXPP..OXOXOXXOOOO..
OXXPP........XOOOO..
OX.OO........XOOO...
OXXXXXXXXXXXXXOO....
OXOXOXOOOOOOOOO.....
....................
......X.............
......X.............
hhh...X.............
