# chateau avec des pieges !
# Rappel : team 0 is top, team 1 bottom
# team 0 robots is R, team 1 is r
RRR...X.............
......X.............
......X.............
....................
OXOXOXOOOOOOOOO.....
OXXXXXXXXXXXXXOO....
OX.OO........XOOO...
OXXBB........XOOOO..
OXXBB..OXOXOXXOOOO..
OXOBB...............
OXOBB...............
OXXBB..OXOXOXXOOOO..
OXXBB........XOOOO..
OX.OO........XOOO...
OXXXXXXXXXXXXXOO....
OXOXOXOOOOOOOOO.....
....................
......X.............
......X.............
rrr...X.............
