# Generated by the map editor
20 20
HHH...X.............
......X.............
..............O..OO.
..............O.....
OXOXOXOOOOO..OO....O
OXXXXXXXXXX..XOO...O
OX.OO........XOOO...
OXXPP........XOOOO..
OXXPP..OXOXOXXOOOOO.
OXOPP...............
OXOPP...............
OXXPP..OXOXOXXOOOOO.
OXXPP........XOOOO..
OX.OO........XOOO...
OXXXXXXXXXX..XOO...O
OXOXOXOOOOO..OO....O
..............O.....
..............O..OO.
......X.............
hhh...X.............
